111111111111111111111111111111111111111111111111111111111111
1000000C00000000000000000000000000000000000000000000000000C1
100011111110000000000011111111000000000000000000000000000001
10001000001000000000001C000001000000000000000000000000000001
10001C000010000000000010000001000000000000000000000000000001
1000111110100000000000100000000000000000000C0000000000000001
100000001C1000000C000011111111000000000000000000000000000001
100000001010000000000000000000000000000000000000000000000001
100000001011111111111100000000000000000000000000000000000001
100000001000000000000000000000000000000000000000000000000001
100011111000000000000000000000000000000000000000000000000001
100010000000000000000000000000000000000000000000000000000001
10001000000000000000000C000000000000000000000000000000000001
100010000000000000000000000000000000000000000000000000000001
100011111110000000000000000000000010000000100000100000100001
100000000010000000000000000000000010000000100000100000100001
100000000010C00000000000000000000010000000100000101110100001
100000000011111111111100000000000010000000100000100000100001
100000000000000000000100000000000010000000100000100C00100001
100000000000000000000100000000000010000000100000111110100001
100000000000000000000111111111100010000000100000100000100001
100000000000000000000100000000100010000000100000100000100001
100000000000000000000000000000100010000000100000100P00100001
10000000000000000000010000000010C010000000101111111111100001
100000000000000000000100000000111111111100000000000000000001
100000000000000000000100000000000000000100000000000000000001
100000000000000000000100000000000000000100000000000000000001
100000000000000000000100000000000000000100000000000000000001
100000000000000000000100000000000000000100000000000000000001
100000000000000000000100000C00000000000100000000000000000001
100000000000000000000100000C00000000000100000000000000000001
1E0000000000000000000100000000000000000000000000000000000001
111111111111111111111111111111111111111111111111111111111111
