1111111111111
10010C1C000C1
1000011111001
1P01000E00001
1111111111111