1111111111111
10E1000001001
1011010101101
1000010100001
1111111111111